#{"t_start": 1618843438.9376814, "env_id": null}
r,l,t,done_reason,goal_len
12.456725,85,21.856221,2,1
14.898426,41,32.658227,2,1
14.110057,28,40.355399,2,1
-12.725705,41,52.778329,1,2
14.13199,26,60.120097,2,1
14.199517,107,88.458245,2,1
13.009748,39,99.257019,2,1
14.676974,62,115.120184,2,1
13.590075,71,133.65685,2,1
15.17448,19,139.381077,2,1
10.022588,40,150.058278,2,1
13.708715,148,191.895568,2,1
8.6977,68,209.50676,2,1
